.......B.....
.BBBBB.BBBBB.
.S...B.BS....
BBBB.B.B.BBBB
...B.B.......
.B.B.BBBBBBB.
.B...BPB.....
.BBBBB.B.BBBB
.B.....B.....
.B.BBB.BBBBB.
.B.B.B.B...B.
BB.B.B.B.B.B.
.S.B...B.BSB.
.BBB.BBB.B.B.
.B.......B...